        1111111111111111111111111
        1000000000110000000000001
        1011000001110000000000001
        1001000000000001000000001
111111111011000001110000100000001
100000000011000001110111110111111
11110111111111011100000100001
11110111111111011101020010001
11000000110101011100000010001
100000000000000011000N0010001
10000000000000001101010010001
1100000111010101111101111000111
11110111 1110101 101111010001
11111111 1111111 111111111111