
R   1920 1080
NO ./img/colorstone.xpm

SO ./img/redbrick.xpm
WE                      ./img/greystone.xpm
EA            ./img/wood.xpm


S ./img/bb.xpm

F 105, 105, 105
C 70, 130, 180



       1111111111111111111111111111
       1000022220110000000000000001
       110110000011100000020000011
       1100100000000000000N0000001
1111111110110000011100000000000011
100000000011000001110111111111111
111101111111110111000000100001
11110111111111011101010010001
10000001101010111022220100011
10002000000000001100000010011
10000000000000001101100000011
11000001110101011111011110011
11110111 1110101 101111010001
11111111 1111111 111111111111
