        1111111111111111111111111
        1000000000110000000000001
        1011000001110000000000001
        1001000000000001000000001
111111111011000001110000100000001
100000000011000001112111110111111
11110111111111011100S00100001
11110111111111011101222210001
11000000110101011100222210001
10000000000000001122222210001
10000000000000001101010010001
11000001110101011111011110001
11110111 1110101 101111010001
11111111 1111111 111111111111