R 1920 1080
NO ./img/colorstone.xpm
SO ./img/redbrick.xpm
WE                      ./img/greystone.xpm


EA            ./img/wood.xpm




S ./img/bb.xpm
F 128, 128, 128
C 65, 105, 225



        1111111111111111111111111
        1000000000110000000000001
        1011000001110000002000001
        1001000000000000000000001
111111111011000001110000000000001
100000000011000001110111111111111
11110111111111011100000010001
11110111111111011101010010001
1000000110101011102222010001
10002000000000001100000010001
1000000000000000110110000001
11000001110101011111011110N0111
11110111 1110101 101111010001
11111111 1111111 111111111111