11111111
10101001
10000001
1100N011
10010001
11111111
        1111111111111111111111111
        1000000000110000000000001
        10110000011100000002000001
        1001000000000001000000001
111111111011000001110000100000001
100000000011000001110111110111111
11110111111111011100000010001
11110111111111011101010001001
11000000110101011100000010001
10002000000000001100000010001
10000000000000001101010010001
1100000111010101111101111000111
11110111 1110101 101111010001
11111110001 1111111 111111111111